 MMMMMMM            MMMMM
 MMMMMMM            MMMMM
 M                      M
 M                      M
 M                      M
 M                      M
 M                      M
 M                      M
 M                      M
 M                      M
 M                      M
 M                      M
 M                      M
 M                      M
 M                      M
 M                      M
 M                      M
 MMMMMMMMMMMMMMMMMMMMMMMM